WE ./textures/cheese_museum.xpm
EA ./textures/cheese_museum2.xpm
NO ./textures/cheese_art.xpm
SO ./textures/toilet_door.xpm

F 220,94,185
C 196,156,63

1111111111111111
11111111111000001
1111111100001111
1000000001000001
1111000001111101
1000000E00000101
1011100100000101
1010000100000101
1110111111111101
  10111000000001
  10100011111111
  101011101
  100000001
  111111101
11100000001
11101111111
11111
