WE ./textures/cheese_museum.xpm
EA ./textures/cheese_museum2.xpm
NO ./textures/cheese_art.xpm
SO ./textures/toilet_door.xpm

F 220,210,185
C 196,156,63

11111111111111
10000000000001
1000S000000001
10000001000001
10000000000E01
10000000000001
11111111111111
