WE 	   ./textures/cheese_museum.xpm




NO                       ./textures/cheese_art.xpm

SO   					./textures/toilet_door.xpm



F  220,  210,		185



C 			196, 156	,          63



EA ./textures/cheese_museum2.xpm
11111111111111
10000000000001
10000000000001
10000001000001
10000000000001
100000000000N1
11111111111111
