WE ./textures/cheese_museum.xpm
EA ./textures/cheese_museum2.xpm
NO ./textures/cheese_art.xpm
SO ./textures/toilet_door.xpm

F 239,192,80
C 91,94,166

1111111111111111111111111111111111
1111111111100000000000000000000001111111111
1111111100001111000000000000010000000000001
1000000001000001000000000000010000000000001
1111000001111101000000000000000001111111111
1000000N00000101111011111111111111
101110010000010000001
101000010000010111111
1110111111111101
  10111000000001
  10100011111111
  101011101
  100000001
  111111101
11100000001
11101111111
11111
