WE ./textures/cheese_museum.xpm
EA ./textures/cheese_museum2.xpm
NO ./textures/cheese_art.xpm
SO ./textures/toilet_door.xpm

F 239,192,80
C 91,94,166

1111111111111111111111111111111111
11111111111000000000000000000000011111111111111111111111111111111111111
11111111000011110000000000000100000000000000000000000000000000000000001
10000000010000010000000000000100000000000000000000000000000000000000001
11110000000001010000000000000000000000000000000000000000000000000000001
1000000N000001011110100000000000000000000000000000000000000000000000001
10111001000001000000100000000000000000000000000000000000000000000000001
10100001000001011111100000000000000000000000000000000000000000000000001
11101111111111011111100000100010010000100001000100000100000100000010001
  101110000000011111100000000000000000000000000000000001001001000100001
  10100011111111    000000000000000000000000000000000000000000000000001
  101011101111111111111111111111111111111110000000000000000000000000001
  100000111111111111111111111111111111111110000000000000000000000000001
  111111111111111111111111111111111111111110000000000000000000000000001
11111111111111111111111111111111111111111110000000000000000000000000001
11111111111111111111111111111111111111111110000000000000000000000000001
11111111111111111111111111111111111111111110000000000000000000000000001
11111111111111111111111111111111111111111110000000000000000000000000001
11111111111111111111111111111111111111111110000000000000000000000000001
11111111111111111111111111111111111111111110000000000000000000000000001
11111111111111111111111111111111111111111110000000000000000000000000001
11111111111111111111111111111111111111111110000000000000000000000000001
11111111111111111111111111111111111111111110000000000000000000000000001
11111111111111111111111111111111111111111110000000000000000000000000001
11111111111111111111111111111111111111111110000000000000000000000000001
11111111111111111111111111111111111111111110000000000000000000000000001
11111111111111111111111111111111111111111110000000000000000000000000001
11111111111111111111111111111111111111111110000000000000000000000000001
11111111111111111111111111111111111111111110000000000000000000000000001
11111111111111111111111111111111111111111110000000000000000000000000001
11111111111111111111111111111111111111111110000000000000000000000000001
11111111111111111111111111111111111111111110000000000001100000000000001
11111111111111111111111111111111111111111110000000000010010000000000001
11111111111111111111111111111111111111111110000000000100001000000000001
11111111111111111111111111111111111111111110000000001000000100000000001
11111111111111111111111111111111111111111110000000010000000010000000001
11111111111111111111111111111111111111111110000000100000000001000000001
11111111111111111111111111111111111111111110000001000000000000100000001
11111111111111111111111111111111111111111110000010000000000000010000001
11111111111111111111111111111111111111111110000100000000000000001000001
11111111111111111111111111111111111111111110001000000000000000000100001
11111111111111111111111111111111111111111110000000000000000000000000001
11111111111111111111111111111111111111111111111111111111111111111111111
